....|.....|...|.....
.|..|.....|.|.|..1..
.|0.|..|....|.|.....
.|.||..|..|||||.....
.|||...|............
.......|....|.......