...........|.......................|..............
.....0.....|.......................|..............
...........|...|.....|||||||||.|||||..............
........||||...|.....|.......|.|..................
...............|.....|...|||||.|..................
....|..|.......|.....|...|.....|..................
....|..||||||..|.....|...|...|.|||||..............
....|..|....|........|...|...|.....|..............
||..|..|.............|...|||.|||||||...|||||......
.|..|......|||||||||||.....|.|.........|...|......
.|.....|...|......|........|||.........|...|......
.|..|..|...|...............................|......
....|......|......|..........|||||||.|||||||......
.|..|..||.||||.||.||||..||||||....................
.|.....|........|.|...............................
.||||..|........|.|...............................
..................|...............................
................|.|......................1........
................|.|...............................
................|.|...............................