........
....|...
..0.|.1.
....|...
........
........