....|...
.|..|.1.
.|0.|...
.|.||...
.|||....
........