....|...
....|...
..0.|.1.
..|||...
...|....
...|....